XXXXXXXXXXXXXXXXXXXXXXXXXXXXXXXXXX
X                X               X
X                X               X
X                X               X
X                X               X
X                X               X
X                X               X
X                X               X
X                                X
X   S                        E   X
X                                X
X                                X
X                X               X
X                X               X
X                X               X
X                X               X
X                X               X
X                X               X
XXXXXXXXXXXXXXXXXXXXXXXXXXXXXXXXXX
