RRRRRRRXXXXXXXXRRROOOOOOOOOOOOOOOO
R      X      X  R               O
R      X      X  R               O
R      XXX  XXX  R       1       O
R                R               O
R                R               O
R                R               O
R                                O
R   S                            O
R                                O
R                R               O
R                R               O
R                R               O
R                R               O
R                R               O
R                R               O
RRRRRRRRRRRRRRRRRROOOOOOOOOEOOOOOO
