RRRRRRRXXXXXXXXRRROOOOOOOOOOOOOOOO
R      X      X  R               O
R      X      X  R               O
R      XXX  XXX  R               O
R                R               O
R                R               O
R                R               O
R                                O
R   S                        E   O
R                                O
R                R               O
R                R               O
R                R               O
R                R               O
R                R               O
R                R               O
RRRRRRRRRRRRRRRRRROOOOOOOOODOOOOOO
