RRRRRRRRRRRRRRRRRRRRRRRRRRRRRRRRRR
R                                R
R   S                            R
R                                R
RRRRRRRRRRRRRRR      RRRRRRR    RR
R             R      R           R
R             R      R           R
R             R      R           R
RRRRR     RRRRR      R           R
R             R      R           R
R             R      RRRRRRR     R
R             R      R     R     R
R             R      R     R     R
R             R      R     R     R
RRRRRRR       R            R     R
R     R       R            R     R
R  1  R                    R     R
R     R              R     R     R
RR    RRRRRRRRR      R     R     R
R             R      R     R     R
R             R      RRRRRRR     R
R                    R           R
R                    R           R
R             R      R           R
RRRRRRRRRRRRRRRRRRRRRRRRRRRRERRRRR
