XXXXXXXXXXXXXXXRRRRRRRRRRRRRRRXXXXXXXXXXXXXXXX
X             X               X              X
X    X    X   X               X    XXXXXX    X
X    X    X                        X    X    X
X    X    XXXXX                              X
XXXXXX        X                     XXXX     X
X       XXX   X               X              X
X   X     X   X               XXXXXXX    XXXXX
X   X  XXX X  X                              R
X   X  X1     X     XXXX   XXXX              R
XXXXXXXXXXXXXXX     X         X              R
R                   X         X              E
R                        S                   R
R                   X         X              R
R   X   XXXXXXXX    X         X              R
R   X   X      X    XXXX   XXXXXXXXX    XXXXXX
R   X   X  XX  X            X                X
R   X   X   X  X            X                X
R   X   X   X  X            XXX   XXX        X
R   X   XXXXX  X            X       X        X
R   X          X            X      XX        X
R   XXXXXXXXXXXX            X     X          X
R                           X   X   X        X
R                           X XX    X        X
RRRRRRRRRRRRRRRRRRRRRRRRRRRRXXXXXXXXXXXXXXXXXX
