XXXXXXXXXXXXXXXRRRRRRRRRRRRRRRRRRRRRRRRRRRRRRR
X             X                              R
X    X    X   X                              R
X    X    X                                  R
X    X    XXXXX                              R
XXXXXX        X                              R
X       XXX   X                              R
X   X     X   X                              R
X   X  XXX X  X                              R
X   X  X1     X                              R
XXXXXXXXXXXXXXX                              R
R                                            R
R                       S                    R
R                                            R
R                                            E
R                                            R
R                                            R
R                                            R
R                                            R
R                                            R
R                                            R
R                                            R
R                                            R
R                                            R
RRRRRRRRRRRRRRRRRRRRRRRRRRRRRRRRRRRRRRRRRRRRRR
