XXXXXXXXXXXXXXXXXXXXXXXXXXXXXXXXXXXXXXXXXXXXXXXXXX
X                    F                           X
X                    FFFFFFFFFFFFFF              X
X                                                X
X                                                X
X            XXXXXXXXXXXXXXXXXXXXXXXXXXXXX       X
X            X                           X       X
X            X                           X       X
XFFFFF       X    XXXXXXXXXXXXXXXXXXX    X       X
X    F       X    X                 X    X   1   X
X    F       X    X      S          X    X       X
X            X    X            X    X    XXXXXXXXX
X    F       X    XXXXXXXXXXXXXX    X    XXXXEXXXX
X    F       X                      X    X       X
X    F       X                      X    X       X
X    F       XXXXXXXXXXXXXXXXXXXXXXXX    X       X
XFFFFF                                   X       X
X       XXXXXXXXXXXXXXXXXXXXXXXXXXXXXXXXXX       X
X                                                X
XXXXXXXXXXXXXXXXXXXXXXXXXXXXXXXXXXXXXXXXXXXXXXXXXX
