XXXXXXXXXXXXXXXXXXXXXXXXXXXXXXXXXXXXXXXXXXXXXXXXXX
X        F                1                F     X
X                                         F      X
X             XXXXXXXXXXXXXXXXXXXXXXXXX  F       X
X           F X                       X F        X
X            FX  XXXXXXX   XXXXXXX    XF         X
X                X               X               X
X                X  XXXXXXXXXXX  X               X
X                X  X         X  X               X
X                X               X               X
X                X       S       X               X
X                X               X               X
X                X  X         X  X               X
X                X  XXXXXXXXXXX  X               X
X                X               X               X
X          FX    XXXXXXX   XXXXXXX   XF          X
X         F X                        X F         X
X        F  XXXXXXXXXXXXXXXXXXXXXXXXXX           X
X       F                                        X
X      F                                  F      X
XXXXXXXXXXXXXXXXXXXXXXXXXEXXXXXXXXXXXXXXXXXXXXXXXX
