FFFFFFFFFFFFFFFFFFFFFFFFFFFFFFFFFFFFFFFFFFFFFFFFF     
F                                               F     
F    S                   F                      F     
FFFFFFFFFFFFFFFFFFFFFFFFFF                      F     
                         F                      F     
                    OOOOOF                      FOOOOO
                    O                                O
                    O                                O
                    O                                O
                    O   OF                      FO   O
                    O   OF                      FO   O
                    O   OF                      FO   O
                    O   OF                      FO   O
                    O   OFFFFFFFFFFFFEFFFFFFFFFFFO   O
                    O   O                        O   O
                    O   O                        O   O
                    O   OOOOOOOOOOOOOOOOOOOOOOOOOO   O
                    O   O                        O   O
                    O   O    0       0      0    O   O
                    O   O                        O   O
                    O                                O
                    O                                O
                    O                                O
                    O   O                        O   O
                    O   O                        O   O
                    OOOOO                        OOOOO
                        O    1       0      0    O    
                        O                        O    
                        OOOOOOOOOOOOOOOOOOOOOOOOOO    
